3_4.map
[RSC]
G grass.png
M mountain.png
D dirt.png
[AT]
............MMM.............
............MMM.............
............MMM.............
............MMM.............
............MMM.............
............MMM.............
............MMM.............
............MMM.............
............MMM.............
............MMM.............
............MMM.............
............MMM.............
............MMM.............
............MMM.............
MMMMMMMMMMMMMMM.............
MMMMMMMMMMMMMMM.............
MMMMMMMMMMMMMMM.............
............................
............................
............................
............................
............................
............................
............................
............................
............................
............................
............................
[UNDER]
GGGGGGGGGGGGMMMDDDDDDDDDDDDD
GGGGGGGGGGGGMMMDDDDDDDDDDDDD
GGGGGGGGGGGGMMMDDDDDDDDDDDDD
GGGGGGGGGGGGMMMDDDDDDDDDDDDD
GGGGGGGGGGGGMMMDDDDDDDDDDDDD
GGGGGGGGGGGGMMMDDDDDDDDDDDDD
GGGGGGGGGGGGMMMDDDDDDDDDDDDD
GGGGGGGGGGGGMMMDDDDDDDDDDDDD
GGGGGGGGGGGGMMMDDDDDDDDDDDDD
GGGGGGGGGGGGMMMDDDDDDDDDDDDD
DDDDDDDDDDDDMMMDDDDDDDDDDDDD
DDDDDDDDDDDDMMMDDDDDDDDDDDDD
DDDDDDDDDDDDMMMDDDDDDDDDDDDD
DDDDDDDDDDDDMMMDDDDDDDDDDDDD
MMMMMMMMMMMMMMMDDDDDDDDDDDDD
MMMMMMMMMMMMMMMDDDDDDDDDDDDD
MMMMMMMMMMMMMMMDDDDDDDDDDDDD
DDDDDDDDDDDDDDDDDDDDDDDDDDDD
DDDDDDDDDDDDDDDDDDDDDDDDDDDD
DDDDDDDDDDDDDDDDDDDDDDDDDDDD
DDDDDDDDDDDDDDDDDDDDDDDDDDDD
DDDDDDDDDDDDDDDDDDDDDDDDDDDD
DDDDDDDDDDDDDDDDDDDDDDDDDDDD
DDDDDDDDDDDDDDDDDDDDDDDDDDDD
DDDDDDDDDDDDDDDDDDDDDDDDDDDD
DDDDDDDDDDDDDDDDDDDDDDDDDDDD
DDDDDDDDDDDDDDDDDDDDDDDDDDDD
DDDDDDDDDDDDDDDDDDDDDDDDDDDD
[ENTITY]
