Tile4_3
[RSC]
G grass.png
M rock.png
[AT]
............................
............................
............................
............................
............................
............................
............................
M...........................
M...........................
M...........................
M...........................
MM..........................
MM..........................
MM..........................
MMM.........................
MMMM........................
MMMM........................
MMMM........................
MMMM........................
MMMMM.......................
MMMMM.......................
MMMMMM......................
MMMMMMMMM...................
MMMMMMMMMMMM................
[UNDER]
GGGGGGGGGGGGGGGGGGGGGGGGGGGG
GGGGGGGGGGGGGGGGGGGGGGGGGGGG
GGGGGGGGGGGGGGGGGGGGGGGGGGGG
GGGGGGGGGGGGGGGGGGGGGGGGGGGG
GGGGGGGGGGGGGGGGGGGGGGGGGGGG
GGGGGGGGGGGGGGGGGGGGGGGGGGGG
GGGGGGGGGGGGGGGGGGGGGGGGGGGG
GGGGGGGGGGGGGGGGGGGGGGGGGGGG
GGGGGGGGGGGGGGGGGGGGGGGGGGGG
.GGGGGGGGGGGGGGGGGGGGGGGGGGG
.GGGGGGGGGGGGGGGGGGGGGGGGGGG
.GGGGGGGGGGGGGGGGGGGGGGGGGGG
.GGGGGGGGGGGGGGGGGGGGGGGGGGG
..GGGGGGGGGGGGGGGGGGGGGGGGGG
..GGGGGGGGGGGGGGGGGGGGGGGGGG
..GGGGGGGGGGGGGGGGGGGGGGGGGG
...GGGGGGGGGGGGGGGGGGGGGGGGG
....GGGGGGGGGGGGGGGGGGGGGGGG
....GGGGGGGGGGGGGGGGGGGGGGGG
....GGGGGGGGGGGGGGGGGGGGGGGG
....GGGGGGGGGGGGGGGGGGGGGGG
......GGGGGGGGGGGGGGGGGGGGGG
.........GGGGGGGGGGGGGGGGGGG
............GGGGGGGGGGGGGGGG
[ENTITY]



