55.map
28,24
[RSC]
G,grass.png
M,mountain.png
O,ocean.png
[AT]
########################
########################
########################
########################
########################
#################.......
#################.......
#################.......
#################.......
[UNDER]
MMMMMMMMMMMMMMMMMMMMMMMM
MOOOOOOOOOOOOOOOOOOOOOOO
MOOOOOOOOOOOOOOOOOOOOOOO
MOOOOOOOOOOOOOOOOOOOOOOO
MOOOOOOOOOOOOOOOOOOOOOOO
MOOOOOOOOOOOOOOOOGGGGGGG
MOOOOOOOOOOOOOOOOGGGGGGG
MOOOOOOOOOOOOOOOOGGGGGGG
MOOOOOOOOOOOOOOOOGGGGGGG
