55.map
28,24
[RSC]
G,grass.png
M,mountain.png
O,ocean.png
[AT]
##########
##########
##########
##########
##########
######....
######....
######....
######....
[UNDER]
MMMMMMMMMM
MOOOOOOOOO
MOOOOOOOOO
MOOOOOOOOO
MOOOOOOOOO
MOOOOOGGGG
MOOOOOGGGG
MOOOOOGGGG
MOOOOOGGGG
