The (7,1) position in the map grid

[RSC]
O <OCEAN.png>
S <SAND.png>
B <BRIDGE.png>
G <GRASS.png>

[AT]
OOOOOOOOOOOOOOOOOOOOOOOOOOOO
OOOOOOOOOOOOOOOOOOOOOOOOOOOO
OOOOOOOOOOOOOOOOOOOOOOOOOOOO
OOOOOOOOOOOOOOOOOOOOOOOOOOOO
OOOOOOOOOOOOOOOOOOOOOOOOOOOO
OOOOOOOOOOOOOOOOOOOOOOOOOOOO
OOOOOOOOOOOOOOOOOOOOOOOOOOOO
OOOOOOOOOOOOOOOOOOOOOOOOOOOO
OOOOOOOOOOOOOOOOOOOOOOOOOOOO
OOOOOOOOOOOOOOOOOOOOOOOOOOOO
OOOOOOOOOOOOOOOOOOOOOOOOOOOO
OOOOOOOOOOOOOOOOOOOOOOOOOOOO
OOOOOOOOOOOOOOOOOOOOOOOOOOOO
OOOOOOOOOOOOOOOOOOOO........
OOOOOOOOOOOOOOOOOOO.........
.....................OOOOOOO
....................OOOOOOOO
OOOOOOOOOOOOOOOOOOOOOOOOOOOO
OOOOOOOOOOOOOOOOOO..........
OOOOOOOOOOOOOOOO............
OOOOOOOOOOOOOO..............
OOOOOOOOOOOO................
OOOOOOOOOOO.................
OOOOOOOOOO..................

[UNDER]
............................
............................
............................
............................
............................
............................
............................
............................
............................
............................
............................
............................
............................
....................BBBBBBBB
...................BBBBBBBBB
BBBBBBBBBBBBBBBBBBBBB.......
BBBBBBBBBBBBBBBBBBBB........
............................
..................SSSSSSSSSS
................SSSSSSSSSSSS
..............SSSSSSSSSSSSSS
............SSSGGGGGGGGGGGGG
...........SSSGGGGGGGGGGGGGG
..........SSSGGGGGGGGGGGGGGG

[ENTITY]
