5_8.map
[RSC]
G grass.png
M mountain.png
# waterToxic.png
W wall.png
R rubble.png
[AT]
MMWWWWWWWWWWWWWWWWWWWWWWWWWW
MM..................WWW.....
MM..WWWWWWWWWWWWWW..WWW....M
MM..W............W..WWW....M
MM...............W..WWW....M
MM.....WWWWWWWW..WWWWWW....M
MM.....W.........W..WWW....M
MM.....W.........W..WWW....M
MM.....W............WWW....M
.......W...WWWWWWWWWWWW....M
.......W...WW..............M
.......W...WW..............M
.......W...WW..............M
MM.....W...WW..............M
MM.....W...WWWWWWWWWWWWWWWWM
MM.....W....................
MM.....W....................
MM.....WWWWWWWWWWWWWWWWWWWWW
MM..........................
MM.###.................MMM..
MM.###.................MMM..
MM.#################...MMM..
MM.#################...MMM..
MM..........................
[UNDER]
MMGGGGGGGGGGGGGGGGGGGWWWGGGG
MMGGGGGGGGGGGGGGGGGGGWWWGGGG
MMGGGGGGGGGGGGGGGGGGGGGGGGGG
MMGGGGGGGGGGGGGGGGGGGGGGGGGG
MMGGGGGGGGGGGGGGGGGGGGGGGGGG
MMGGGGGGGGGGGGGGGGGGGGGGGGGG
MMGGGGGGGGGGGGGGGGGGGGGGGGGG
MMGGGGGGGGGGGGGGGGGGGGGGGGGG
MMGGGGGGGGGGGGGGGGGGGGGGGGGG
MMGGGGGGGGGGGGGGGGGGGGGGGGGG
MMGGGGGGGGGGGGGGGGGGGGGGGGGG
MMGGGGGGGGGGGGGGGGGGGGGGGGGG
MMGGGGGGGGGGGGGGGGGGGGGGGGGG
MMGGGGGGGGGGGGGGGGGGGGGGGGGG
MMGGGGGGGGGGGGGGGGGGGGGGGGGG
MMGGGGGGGGGGGGGGGGGGGGGGGGGG
MMGGGGGGGGGGGGGGGGGGGGGGGGGG
MMGGRGGGGGGGGGGGGGGGGGGGGGGG
MMGGGGGGGGGGGGGGGGGGGGGGGGGG
MMGGGGGGGGGGGGGGGGGGGGGGGGGG
MMGGGGGGGGGGGGGGGGGRGGGGGGGG
MMGGGGGGGGGGGGGGGGGGGGGGGGGG
MMGGGGGGGGGGGGGGGGGGGGGGGGGG
MMGGGGGGGGGGGGGGGGGGGGGGGGGG
[ENTITY]
Skel skeleton.png 512 352
Skel2 skeleton.png 576 352



















