5_8.map
[RSC]
G grassDead.png
M mountain.png
# waterToxic.png
W wall.png
R rubbleDead.png
T treeDying.png
[AT]
MMWWWWWWWWWWWWWWWWWWWWWWWWWW
MM..................TWT.....
MM..WWWWWWWWWWWWWW..TWT....M
MM..W............W..TWT....M
MM...............W..WWW....M
MM.....WWWWWWWW..WWWWWW....M
MM..T.TW.........W..TWT....M
MM..T.TW.T.T.T...W..TWT....M
MM..T.TW............TWT....M
......TW...WWWWWWWWWWWW....M
......TW...WW..............M
......TW...WW..............M
......TW...WW..............M
MM..W.TW...WW..............M
MM..T.TW...WWWWWWWWWWWWWWWWM
MM..T.TW....................
MM..T.TW....................
MM..T..WWWWWWWWWWWWWWWWWWWWW
MM..........................
MM.###.................MMM..
MM.###.T.T.T.T.T.T.T...MMM..
MM.#################...MMM..
MM.#################...MMM..
MM..........................
[UNDER]
MMGGGGGGGGGGGGGGGGGGWWWWGGGG
MMGGGGGGGGGGGGGGGGGGWWWWGGGG
MMGGGGGGGGGGGGGGGGGGGGGGGGGG
MMGGGGGGGGGGGGGGGGGGGGGGGGGG
MMGGGGGGGGGGGGGGGGGGGGGGGGGG
MMGGGGGWGGGGGGGGGGGGGGGGGGGG
MMGGGGGGGGGGGGGGGGGGGGGGGGGG
MMGGGGGGGGGGGGGGGGGGGGGGGGGG
MMGGGGGGGGGGGGGGGGGGGGGGGGGG
MMGGGGGGGGGGGGGGGGGGGGGGGGGG
GRGGGGGGGGGGGGGGGGGGGGGGGGGG
GGGGGGGGGGGGGGGGGGGGGGGGGGGG
GGGGGGGGGGGGGGGGGGGGGGGGGGGG
GRGGGGGGGGGGGGGGGGGGGGGGGGGG
MMGGWGGGGGGGGGGGGGGGGGGGGGGG
MMGGGGGGGGGGGGGGGGGGGGGGGGGG
MMGGGGGGGGGGGGGGGGGGGGGGGGGG
MMGGRGGGGGGGGGGGGGGGGGGGGGGG
MMGGGGGGGGGGGGGGGGGGGGGGGGGG
MMGGGGGGGGGGGGGGGGGGGGGGGGGG
MMGGGGGGGGGGGGGGGGGRGGGGGGGG
MMGGGGGGGGGGGGGGGGGGGGGGGGGG
MMGGGGGGGGGGGGGGGGGGGGGGGGGG
MMGGGGGGGGGGGGGGGGGGGGGGGGGG
[ENTITY]
Skel skeleton.png 512 352
Skel2 skeleton.png 576 352



















