5_9.map
[RSC]
G grassDead.png
M mountain.png
# waterToxic.png
W wall.png
R rubble.png
T treeDying.png
[AT]
MMMMMMMMMMMMMMMMMMMMMMM....M
MMMMMMMMMMMMMMMMMMMMMMM....M
MMMMMMMMMMMMMMMMMMMMMMM....M
MM.............MMMMMMMM....M
MM..#########....MMMMMM....M
MM.##########....MMMMMM....M
MM.######..###...TMMMMT....M
MM..#####........TMMMT....MM
MM..T#####..TTT...MMT....MMM
MM....#####TTTTT........MMMM
MMM...T#####TTTTT......TMMMM
MMMM.........TTTTTTTTTTTMMMM
MMMMM..........TTTTTTT......
MM..MMM..........TTTTT.T....
MM...MMT..........TTT.....TT
MMT...............TTT..T.TTT
MM...MMT..........TTT....TTT
MM..MMM...........TTT..T..TT
MMMMM.............TTT......T
MMM..............TTTTT......
MMM.............TTTTTTT.....
MMMM........................
MMMMMMMMMMMMMMMMMMMMMMMMMMMM
MMMMMMMMMMMMMMMMMMMMMMMMMMMM
[UNDER]
MMGGGGGGGGGGGGGGGGGGGGGGGGGG
MMGGGGGGGGGGGGGGGGGGGGGGGGGG
MMGGGGGGGGGGGGGGGGGGGGGGGGGG
MMGGGGGGGGGGGGGGGGGGGGGGGGGG
MMGGGGGGGGGGGGGGGGGGGGGGGGGG
MMGGGGGGGGGGGGGGGGGGGGGGGGGG
MMGGGGGGGGGGGGGGGGGGGGGGGGGG
MMGGGGGGGGGGGGGGGGGGGGGGGGGG
MMGGGGGGGGGGGGGGGGGGGGGGGGGG
MMGGGGGGGGGGGGGGGGGGGGGGGGGG
MMGGGGGGGGGGGGGGGGGGGGGGGGGG
MMGGGGGGGGGGGGGGGGGGGGGGGGGG
MMGGGGGGGGGGGGGGGGGGGGGGGGGG
MMGGGGGGGGGGGGGGGGGGGGGGGGGG
MMGGGGGGGGGGGRGGGGGGGGGGGGGG
MMGGGGGGGGGGGGGGGGGGGGGGGGGG
MMGGGGGGGGGGGGGGGGGGGGGGGGGG
MMGGGGGGGGGGGGRGGGGGGGGGGGGG
MMGGGGGGGGGGGGGGGGGGGGGGGGGG
MMGGGGGGRGGGGGGGGGGGGGGGGGGG
MMGGGGGGGGGGGGGGGGGGGGGGGGGG
MMGGGGGGGGGGGGGGGGGGGGGGGGGG
MMGGGGGGGGGGGGGGGGGGGGGGGGGG
MMGGGGGGGGGGGGGGGGGGGGGGGGGG
[ENTITY]
Skel skeleton.png 320 480
Skel2 skeleton.png 320 512



















