6_7.map
[RSC]
G grassDead.png
M rocks.png
# waterToxic.png
W wall.png
R rubbleDead.png
T treeDying.png
H barHedgeDead.png
[AT]
MMMMMMMMMMMMMMMMMMMMM...MMMM
MMMMMMMMMMMMMMMMMMMMM...MMMM
MMM...T...MM............MMMM
T...TTT..TTT..T.......TTMMMM
T..TTT....TTTTT.TTTTTT..MMMM
T...............T...TT..MMMM
TT.TT.T.................MMMM
........TT.....TTTTTTTTTMMMM
.....TTTTT.TTTTTT.......MMMM
...TTTTTTTTT............MMMM
TTTTTTT...........TT....MMMM
..............TTTTTTT...MMMM
...........TTTTTTTT.....MMMM
....MMMMTTTTTTTT........MMMM
HHHMMMMMMTTTTT......MMMMMMMM
T####MMMMTTTT.....MMMMMMMMMM
T#####MMMTTT.....MMM....MMMM
TT###MMMMTT...MMMMM..T..MMMM
TTT##MMTTT...MMMMM.....MMMMM
TTMMMMMMTT...MMMM....MMMMMMM
MMMM..MMMM....MMM...MM..MMMM
MMM......MM...MMM...MM..MMMM
MMM...T...MM...MM...MM..MMMM
MMMM..T...MM...MM...MM..MMMM
[UNDER]
GGGGGGGGGGGGGGGGGGGGGGGGGGGG
GGGGGGGGGGGGGGGGGGGGGGGGGGGG
GGGGGGGGGGGGGGGGGGGRGGGGGGGG
GGGGGGGGGGGGGGGGGGGGGGGGGGGG
GGGGGGGGGGGGGGGGGGGGGGGGGGGG
GGGGGGGGGGGGGGGGGGGGGGGGGGGG
GGGGGGGGGGGGGGGGGGGGGGGGGGGG
GGGGGGGGGGGGGGGGGGGGGGGGGGGG
GGGGGGGGGGGGGGGGGGGGGGGGGGGG
GGGGGGGGGGGGGGGGGGGGGGGGGGGG
GGGGGGGGGGGGGGGGGGGGGGGGGGGG
GGGGGGGGGGGGGGGGGGGGGGGGGGGG
GGGGGGGGGGGGGGGGGGGGGGGGGGGG
GGGGGGGGGGGGGGGGGGGGGGGGGGGG
GGGGGGGGGGGGGGGGGGGGGGGGGGGG
GGGGGGGGGGGGGGGGGGGGGGGGGGGG
GGGGGGGGGGGGGGGGGGGGGGGGGGGG
GGGGGGGGGGGGGGGGGGGGGGGGGGGG
GGGGGGGGGGGGGGGGGGGGGGGGGGGG
GGGGGGGGGGGGGGGGGGGGGGGGGGGG
GGGGGGGGGGGGGGGGGGGGGGGGGGGG
GGGGGGGGGGGGGGGGGGGGGGGGGGGG
GGGRGGGGGGGGGGGGGGGGGGGGGGGG
GGGGGGGGGGGGGGGGGGGGGGGGGGGG
[ENTITY]
Skel skeleton.png 320 320


















