6_8.map
[RSC]
G grassDead.png
M rocks.png
# waterToxic.png
W wall.png
R rubbleDead.png
T treeDying.png
[AT]
MMMM..T...MM...TT...TT..MMMM
......T...MM...TT...TT..MMMM
MMMM..T...MM...TT...TT..MMMM
MMM..TT...TT...TT...TT..MMMM
MMMMTTT...TT...TT...TT..MMMM
MMMMTTT...TT...TT...TT..MMMM
MMMMTT....TT...TT...TT..MMMM
MMMMMT...TTTT..TTT......MMMM
MMMMMT...TTTT...TTT.....MMMM
MMMMMM..TTTTTT...TTT...TMMMM
MMMMMM...TTT......TT....MMMM
MMMMMM.................TMMMM
MMMMMM.......MMMMMMMM...MMMM
MMMMMMMMT.T...MMMMMM...TMMMM
MMMMMMMMM.MM...MMMM.....MMMM
.....MMMM.MMM..........TMMMM
......MMM.MMMM..........MMMM
WTT..MMMM.MMMMMM########MMMM
.TT..MM.....MMMMMM####MMMMMM
..T..MM......MMMMMMM##MMMMMM
.....MMT........TMMMMMMMMMMM
....MMMMT....TT...TMMMMMMMMM
..MMMMMMT...........TMMMMMMM
.MMMMMMMMM..............MMMM
[UNDER]
MMGGGGGGGGGGGGGGGGGGGGGGGGGG
GGGGGGGGGGGGGGGGGGGGGGGGGGGG
MMGGGGGGGGGGGGGGGGGRGGGGGGGG
MMGGGGGGGGGGGGGGGGGGGGGGGGGG
MMGGGGGGGGGGGGGGGGGGGGGGGGGG
MMGGGGGGGGGGGGGGGGGGGGGGGGGG
MMGGGGGGGGGGGGGGGGGGGGGGGGGG
MMGGGGGGGGGGGGGGGGGGGGGGGGGG
MMGGGGGGGGGGGGGGGGGGGGGGGGGG
MMGGGGGGGGGGGGGGGGGGGGGGGGGG
MMGGGGGGGGGGGGGGGGGGGGGGGGGG
MMGGGGGGGGGGGGGGGGGGGGGGGGGG
GGGGGGGGGGGGGGGGGGGGGGGGGGGG
GGGGGGGGGGGGGGGGGGGGGGGGGGGG
MMGGGGGGGGGGGGGGGGGGGGGGGGGG
MMGGGGGGGGGGGGGGGGGGGGGGGGGG
MMGGGGGGGGGGGGGGGGGGGGGGGGGG
MMGGGGGGGGGGGGGGGGGGGGGGGGGG
MMGGGGGGGGGGGGGGGGGGGGGGGGGG
GGGGGGGGGGGGGGGGGGGGGGGGGGGG
GGGGGGGGGGGRGGGGGGGGGGGGGGGG
GGGGGGGGGGGGGGGGGGGGGGGGGGGG
MMGRGGGGGGGGGGGGGGGGGGGGGGGG
MMGGGGGGGGGGGGGGGGGGGGGGGGGG
[ENTITY]
Skel skeleton.png 416 32
Skel skeleton.png 576 32
Skel skeleton.png 704 32


















