The (7,0) position in the map grid

[RSC]
O water.png
S sand.png
B waterWithStone.png

[AT]
OOOOOOOOOOOOOOOOOOOOOOOOOOOO
OOOOOOOOOOOOOOOOOOOOOOOOOOOO
OOOOOOOOOOOOOOOOOOOOOOSSSSSS
OOOOOOOOOOOOOOOOOOOSSSSSSSSS
OOOOOOOOOOOOOOOOSSSSSSSSSSSS
OOOOOOOOOOOOOOOOSSSSSSSSSSSS
OOOOOOOOOOOOOOOSSSSSSSSSSSSS
OOOOOOOOOOOOOOOSSSSSSSSSSSSS
OOOOOOOOOOOOOOOSSSSSSSSSSSSS
OOOOOOOOOOOOOOSSSSSSSSSSSSSS
OOOOOOOOOOOOOOSSSSSSSSSSSSSS
OOOOOOOOOOOOOSSSSSSSSSSSSSSS
OOOOOOOOOOOOOSSSSSSSSSSSSSSS
OOOOOOOOBBBBBSSSSSSSSSSSSSSS
BBBBBBBBBBBBBSSSSSSSSSSSSSSS
BBBBBBBBBBOOOSSSSSSSSSSSSSSS
OOOOOOOOOOOOOOSSSSSSSSSSSSSS
OOOOOOOOOOOOOSSSSSSSSSSSSSSS
OOOOOOOOOOOOOOSSSSSSSSSSSSSS
OOOOOOOOOOOOOOOOSSSSSSSSSSSS
OOOOOOOOOOOOOOOOOOSSSSSSSSSS
OOOOOOOOOOOOOOOOOOOOSSSSSSSS
OOOOOOOOOOOOOOOOOOOOOOOOOOOO
OOOOOOOOOOOOOOOOOOOOOOOOOOOO

[UNDER]
............................
............................
......................SSSSSS
...................SSSSSSSSS
................SSSSSSSSSSSS
................SSSSSSSSSSSS
...............SSSSSSSSSSSSS
...............SSSSSSSSSSSSS
...............SSSSSSSSSSSSS
..............SSSSSSSSSSSSSS
..............SSSSSSSSSSSSSS
.............SSSSSSSSSSSSSSS
.............SSSSSSSSSSSSSSS
........BBBBBSSSSSSSSSSSSSSS
BBBBBBBBBBBBBSSSSSSSSSSSSSSS
BBBBBBBBBB...SSSSSSSSSSSSSSS
.............SSSSSSSSSSSSSSS
.............SSSSSSSSSSSSSSS
..............SSSSSSSSSSSSSS
................SSSSSSSSSSSS
..................SSSSSSSSSS
....................SSSSSSSS
............................
............................

[ENTITY]
skeleton skeletonDown.png 384 576