Tile7_4
[RSC]
W wall.png
M mountain.png
G grass.png
[AT]
................MMMMMMMM....
................MMMMMMMM....
.................MMMMMMM....
..................MMMMMM....
...................MMMMMM...
....................MMMMMMMM
......................MMMMMM
.......................MMMMM
..........................MM
............................
............................
............................
............................
............................
............................
MMMMMMMMMMMMMM..............
MMMMMMMMMMMMMMM.............
MMMMMMMMMMMMMMM.............
MMMMMMMMMMMMMMM.............
MMMMMMMMMMMMMMM.............
MMMMMMMMMMMMMMM.............
MMMMMMMMMMMMMMMM............
MMMMMMMMMMMMMMMM............
MMMMMMMMMMMMMMMM............
MMMMMMMMMMMMMMMMM...........
MMMMMMMMMMMMMMMMM...........
MMMMMMMMMMMMMMMMM...........
MMMMMMMMMMMMMMMMM...........
MMMMMMMMMMMMMMMMM...........
MMMMMMMMMMMMMMMMMMM.........
MMMMMMMMMMMMMMMMMMMM........
MMMMMMMMMMMMMMMMMMMM........
MMMMMMMMMMMMMMMMMMMM........
MMMMMMMMMMMMMMMMMMMMM.......
MMMMMMMMMMMMMMMMMMMMM.......
[UNDER]
GGGGGGGGGGGGGGGG........GGGG
GGGGGGGGGGGGGGGG........GGGG
GGGGGGGGGGGGGGGGG.......GGGG
GGGGGGGGGGGGGGGGGG......GGGG
GGGGGGGGGGGGGGGGGGG......GGG
GGGGGGGGGGGGGGGGGGGG.....GGG
GGGGGGGGGGGGGGGGGGGGGG......
GGGGGGGGGGGGGGGGGGGGGGG.....
GGGGGGGGGGGGGGGGGGGGGGG.....
GGGGGGGGGGGGGGGGGGGGGGGGGG..
GGGGGGGGGGGGGGGGGGGGGGGGGGGG
GGGGGGGGGGGGGGGGGGGGGGGGGGGG
GGGGGGGGGGGGGGGGGGGGGGGGGGGG
GGGGGGGGGGGGGGGGGGGGGGGGGGGG
GGGGGGGGGGGGGGGGGGGGGGGGGGGG
GGGGGGGGGGGGGGGGGGGGGGGGGGGG
GGGGGGGGGGGGGGG.............
GGGGGGGGGGGGGGG.............
GGGGGGGGGGGGGGG.............
GGGGGGGGGGGGGGG.............
GGGGGGGGGGGGGGG.............
GGGGGGGGGGGGGGGG............
GGGGGGGGGGGGGGGG............
GGGGGGGGGGGGGGGG............
GGGGGGGGGGGGGGGGG...........
GGGGGGGGGGGGGGGGG...........
GGGGGGGGGGGGGGGGG...........
GGGGGGGGGGGGGGGGG...........
GGGGGGGGGGGGGGGGG...........
GGGGGGGGGGGGGGGGGGG.........
GGGGGGGGGGGGGGGGGGGG........
GGGGGGGGGGGGGGGGGGGG........
GGGGGGGGGGGGGGGGGGGG........
GGGGGGGGGGGGGGGGGGGGG.......
GGGGGGGGGGGGGGGGGGGGG.......
[ENTITY]