7-9
[RSC]
% wall.png
G grassDead.png

[AT]
%%%%%..%%%%%%%%%%%%%%%%%%%%%
%%%%%..%%......%%......%%...
%......%%......%%......%%...
%......%%..%%..%%..%%..%%..%
%..%%..%%..%%..%%..%%..%%..%
%..%%..%%..%%..%%..%%..%%..%
%..%%..%%..%%..%%..%%..%%..%
%..%%..%%..%%..%%..%%..%%..%
%..%%..%%..%%..%%..%%..%%..%
%..%%..%%..%%..%%..%%..%%..%
%..%%..%%..%%..%%..%%..%%..%
%..%%..%%..%%..%%..%%..%%..%
%..%%..%%..%%..%%..%%..%%..%
%..%%..%%..%%..%%..%%......%
%..%%..%%..%%..%%..%%......%
%..%%..%%..%%..%%..%%%%%%%%%
%......%%..%%......%%%%%%%%%
%......%%..%%......%%.......
%..%%..%%..%%%%%%%%%%.......
%..%%..%%..............%%%%%
%..%%%%%%..............%%%%%
%..%%%%%%%%%%%%%%%%%%%%%%...
%...........................
%%%%%%%%%%%%%%%%%%%%%%%%%%%%

[UNDER]
GGGGGGGGGGGGGGGGGGGGGGGGGGGG
GGGGGGGGGGGGGGGGGGGGGGGGGGGG
GGGGGGGGGGGGGGGGGGGGGGGGGGGG
GGGGGGGGGGGGGGGGGGGGGGGGGGGG
GGGGGGGGGGGGGGGGGGGGGGGGGGGG
GGGGGGGGGGGGGGGGGGGGGGGGGGGG
GGGGGGGGGGGGGGGGGGGGGGGGGGGG
GGGGGGGGGGGGGGGGGGGGGGGGGGGG
GGGGGGGGGGGGGGGGGGGGGGGGGGGG
GGGGGGGGGGGGGGGGGGGGGGGGGGGG
GGGGGGGGGGGGGGGGGGGGGGGGGGGG
GGGGGGGGGGGGGGGGGGGGGGGGGGGG
GGGGGGGGGGGGGGGGGGGGGGGGGGGG
GGGGGGGGGGGGGGGGGGGGGGGGGGGG
GGGGGGGGGGGGGGGGGGGGGGGGGGGG
GGGGGGGGGGGGGGGGGGGGGGGGGGGG
GGGGGGGGGGGGGGGGGGGGGGGGGGGG
GGGGGGGGGGGGGGGGGGGGGGGGGGGG
GGGGGGGGGGGGGGGGGGGGGGGGGGGG
GGGGGGGGGGGGGGGGGGGGGGGGGGGG

[ENTITY]
