The (9,0) position in the map grid

[RSC]
O <OCEAN.png>
S <SAND.png>
B <BRIDGE.png>

[AT]
OOOOOOOOOOOOOOOOOOOOOOOOOOOO
OOOOOOOOOOOOOOOOOOOOOOOOOOOO
OOOOOOOOOOOOOOOOOOOOOOOOOOOO
OOOOOOOOOOOOOOOOOOOOOOOOOOOO
OOOOOOOOOOOOOOOOOOOOOOOOOOOO
OOOOOOOOOOOOOOOOOOOOOOOOOOOO
OOOOOOOOOOOOOOOOOOOOOOOOOOOO
OO........OOOOOOOOOOOOOOOOOO
O............OOOOOOOOOOOOOOO
................OOOOOOOOOOOO
.................OOOOOOOOOOO
..................OOOOOOOOOO
...................OOOOOOOOO
...................OOOOOOOOO
....................OOOOOOOO
....................OOOOOOOO
....................OOOOOOOO
....................OOOOOOOO
...................OOOOOOOOO
.................OOOOOOOOOOO
.............OOOOOOOOOOOOOOO
.........OOOOOOOOOOOOOOOOOOO
OO..OOOOOOOOOOOOOOOOOOOOOOOO
OO..OOOOOOOOOOOOOOOOOOOOOOOO

[UNDER]
............................
............................
............................
............................
............................
............................
............................
..SSSSSSSS..................
.SSSSSSSSSSSS...............
SSSSSSSSSSSSSSSS............
SSSSSSSSSSSSSSSSS...........
SSSSSSSSSSSSSSSSSS..........
SSSSSSSSSSSSSSSSSSS.........
SSSSSSSSSSSSSSSSSSS.........
SSSSSSSSSSSSSSSSSSSS........
SSSSSSSSSSSSSSSSSSSS........
SSSSSSSSSSSSSSSSSSSS........
SSSSSSSSSSSSSSSSSSSS........
SSSSSSSSSSSSSSSSSSS.........
SSSSSSSSSSSSSSSSS...........
SSSSSSSSSSSSS...............
SSSSSSSSS...................
..BB........................
..BB........................

[ENTITY]