9-8
[RSC]
# wall.png
@ wall.png
% wall.png
G grassDead.png

[AT]
#############..##########..#
#############..##########..#
...........##..##..........#
...........##..##..........#
#########..##..##..#########
#########..##..##..#########
...........##..##..##......#
...............##..##......#
#################..######..#
#################..######..#
@@@@@@@@@@@@@@@@@..@@@@@@..@
@..............@@..........@
@..............@@..........@
@..@@@@@@@@@@..@@@@@@@@@@@@@
%..%%%%%%%%%%..%%%%%%%%%%%%%
...%%%%%%%%%%..............%
...%%%%%%%%%%..............%
...%%%%%%%%%%%%%%%%%%..%%..%
.......................%%..%
.......................%%..%
%%%%%%%%%%%%%%%%%%%%%%%%%..%
%%%%%%.....................%
%%%%%%.....................%
%%%%%%..%%%%%%%%%%%%%%%%%%%%

[UNDER]
GGGGGGGGGGGGGGGGGGGGGGGGGGGG
GGGGGGGGGGGGGGGGGGGGGGGGGGGG
GGGGGGGGGGGGGGGGGGGGGGGGGGGG
GGGGGGGGGGGGGGGGGGGGGGGGGGGG
GGGGGGGGGGGGGGGGGGGGGGGGGGGG
GGGGGGGGGGGGGGGGGGGGGGGGGGGG
GGGGGGGGGGGGGGGGGGGGGGGGGGGG
GGGGGGGGGGGGGGGGGGGGGGGGGGGG
GGGGGGGGGGGGGGGGGGGGGGGGGGGG
GGGGGGGGGGGGGGGGGGGGGGGGGGGG
GGGGGGGGGGGGGGGGGGGGGGGGGGGG
GGGGGGGGGGGGGGGGGGGGGGGGGGGG
GGGGGGGGGGGGGGGGGGGGGGGGGGGG
GGGGGGGGGGGGGGGGGGGGGGGGGGGG
GGGGGGGGGGGGGGGGGGGGGGGGGGGG
GGGGGGGGGGGGGGGGGGGGGGGGGGGG
GGGGGGGGGGGGGGGGGGGGGGGGGGGG
GGGGGGGGGGGGGGGGGGGGGGGGGGGG
GGGGGGGGGGGGGGGGGGGGGGGGGGGG
GGGGGGGGGGGGGGGGGGGGGGGGGGGG
GGGGGGGGGGGGGGGGGGGGGGGGGGGG
GGGGGGGGGGGGGGGGGGGGGGGGGGGG
GGGGGGGGGGGGGGGGGGGGGGGGGGGG
GGGGGGGGGGGGGGGGGGGGGGGGGGGG

[ENTITY]
